- - - # -
0 # - # -
# # - 0 -
# # # # #
# # # - #
